R 490 330
NO ./textures/bluestone.xpm
SO ./textures/colorstone.xpm
WE ./textures/greystone.xpm
EA ./textures/redbrick.xpm
S ./textures/barrel.xpm

F 243,249,210
C 209,250,255

111111111111111
100000000000001
100000000000001
100000000000001
100000000000001
100000000000001
100000000000001
10N000000000001
111111111111111