  R 1280 900
  NO ./textures/bluestone.xpm
SO ./textures/colorstone.xpm
   WE    ./textures/greystone.xpm
EA ./textures/redbrick.xpm
S ./textures/barrel.xpm

F 243,254,125
C 209,250,255





11111111
10000001
10000001
10202001
10000001
10000001
10N00001
11111001111
    1000001
    1000001
    1000001
    1000001
    1000001
    1001111
11111001
10000001
10000001
10202001
10000001
10000001
10000001
11111001111
    1000001
    1000001
11111000001
10000000001
11111000001
    1111111
