R 480 320
NO ./path_to_north_texture
SO ./path_to_south_texture
WE ./path_to_west_texture
EA ./path_to_east_texture
S ./path_to_sprite_texture

F 243,249,210
C 209,250,255

1111111
1000001
100E001
1000101
1000001
1000001
1111111