R 1280 1080

NO ./path_to_north_texture
SO ./path_to_south_texture
WE ./path_to_west_texture
EA ./path_to_east_texture
S ./path_to_sprite_texture



F 12,15,241
C 123,54,146



111111111111111111
102010000000000001
100010010000000001
10001E010000000001
111011111110110001
100000010000011111
100100000000010201
120102010000000001
111111111111111111