R 1280 1080

NO ./textures/bluestone.xpm
SO ./textures/colorstone.xpm
WE ./textures/greystone.xpm
EA ./textures/redbrick.xpm
S ./textures/redbrick.xpm



F 12,15,241
C 123,54,146



111111111111111111
102010000000000001
100010010000000001
100010010000000001
111011111110110001
100000010000011111
100100000000010201
12010N010000000001
111111111111111111