R 1280 1080

NO ./textures/bluestone.xpm
SO ./textures/colorstone.xpm
WE ./textures/greystone.xpm
EA ./textures/redbrick.xpm
S ./textures/barrel.xpm



F 243,249,210
C 209,250,255



1111111111111111111111111111111111
1020100000000000010000000000000001
1000100100000000000000000000000001
1000100100000000010000000000000001
1110111111101100011100000000000001
1000000100000111110000020002000W01
1201000000000102000000220002000001
1001000100000000010000000000000001
1111111111111111111111111111111111