R 1280 1080

NO ./textures/bluestone.xpm
SO ./textures/colorstone.xpm
WE ./textures/greystone.xpm
EA ./textures/redbrick.xpm
S ./textures/barrel.xpm



F 12,15,241
C 123,54,146



1111111111111111111111111111111111
1020100000000000010000000000000001
1000100100000000000000000000000001
1000100100000000010000000000000001
1110111111101100011111100000000001
1000000100000111110000000000000001
1001000000000102000000000000000001
12010N0100000000010000000000000001
1111111111111111111111111111111111