R 1280 1080
NO ./textures/dirt.xpm
SO ./textures/oak.xpm
WE ./textures/sand.xpm
EA ./textures/stone_block.xpm
S ./textures/oak.xpm

F 12,15,241
C 123,54,146

  1111111
  1000001
  1000001
  1000001
1110001111
100N000001
1000000011
100111001
100000001
1000000011
1111111111