NO ./textures/bluestone.xpm
SO ./textures/colorstone.xpm
WE ./textures/greystone.xpm
EA ./textures/redbrick.xpm
S ./textures/barrel.xpm

F 243,249,210
C 209,250,255

111111111
1000S0001
100000001
100020001
100000001
120000001
111111111