R 1280 900
NO ./textures/bluestone.xpm
SO ./textures/colorstone.xpm
WE ./textures/greystone.xpm
EA ./textures/redbrick.xpm
S ./textures/barrel.xpm
F 243,249,210
C 209,250,255

11111111111111111111111111111111111111111111111111111111111111111111111111111111
12200000000001000000000000000000000000000000000000000001000000000000000000000001
12000010000201000000000000000000000010000000000000000001000000000000000000000001
10000011111111000001000000000000000010000000000000000001000000000111111100000001
10000000000001000001000000000000000010000000000000000001000000000000000000000001
10000000000001000001000000000000000000000000000000000001000000000000000000000001
10000000N00001111111111111100000000000000000000000000001000200000000020000000001
10000000000001000000000000000000000000000000002000000001000000000000000000000001
11011111111111000000000000000000000000000000000000000001000000000000000000000001
10000000000000000000000000000000000000000000000000000001000000000000000000000001
10000000000000000000000000000000000001201111111000000001000000111100000000000001
10000000000000000000000000000000000001000000000000000001000000000100000000000001
10000000000000000000000000000000000001000000000000000001000000000100020000000001
10000000000000000000000000000000000000000000000000000001000000000100000000000001
10000000000000100000000000000010000000000000000000000001000000000111111000000001
10000000000000100002222000000010000000000000000000000001000000000102000000000001
10000000000000111111111111111110000000000000000000000001111110111111111111111111
10000000000000000000000000000000000000000000000000000001000000000000000000000001
10000000000000000000000000000000000000000000000000000001000000000000000000000001
10000000000000000000000000000000000000000000000000000001000000000000000000000001
10000000000000000000000000000000000000000000000000000001111111111111111011111111
10000000000000000000000000000000000000000000000000000000000000000000000000000001
10000000000000000000000000000000000000000000000000000000000000000000000000000001
11111111110111111111111111111110111111111111110000000000000000000000000000000001
10010001000000000021000000000000000000000000010000000000000000000000000000000001
10010001000011010001000000000000000000000000010000000000000000000000000000000001
10010001000010010001000000000000000000000000010000000000000000000000000000000001
10010200000010110001000000000000000000000000010000000000000000000000000000000001
10010001111110000001000000000021000000000000010000000000000000000000000000000001
10010001000000000001000000000000000000000000010000000000000000000000000000000001
10010001000000000001000000000000000000000000010000000000000000000000000000000001
10011101000000000001000000000000000000000000010000000000000000000000000000000001
10000000000000000000000000000000000000000000000000000000000000000000000000000001
10000000000000000000000000000000000000000000000000000000000000000000000000000001
11111111111111111111111111111111111111111111111111111111111111111111111111111111