R 490 330
NO ./textures/bluestone.xpm
SO ./textures/colorstone.xpm
WE ./textures/greystone.xpm
EA ./textures/redbrick.xpm
S ./textures/barrel.xpm

111111111
1000S0001
100000001
100020001
100000001
120000001
111111111