R 1280 1080

NO 228,25,25
SO 25,228,25
WE 25,25,228
EA 35,120,130
S 240,30,75

F 243,249,210
C 209,250,255

11111
10001
10001
10N01
11111